###############
#             #
#             #
#             #
#             #
#             #
#   #         #
#             #
###############
