   ##########################################################
                     #        #     #                    #  #
####  #######  #############  ####  #######  #############  #
#        #  #  #              #           #     #  #     #  #
#  #######  ####  #  #  ####  ####  ####  ####  #  #  ####  #
#     #           #  #     #     #  #     #     #        #  #
#  #  ####  ####  #######  ####  #  ####  #  #######  ####  #
#  #  #     #     #     #     #  #  #  #              #  #  #
####  ####  #######  #  #############  #############  #  #  #
#     #     #     #  #     #                    #     #  #  #
#  ####  ####  ####  #  #######  #######  #######  ####  #  #
#  #  #           #  #           #     #     #  #  #     #  #
#  #  #######  #######  ####  #######  ####  #  #  #  ####  #
#     #              #  #     #        #  #        #     #  #
#  #  #  ###################  ####  ####  #  ####  #  ####  #
#  #                 #     #  #        #        #           #
################  ####  ####  #  ####  #######  ##########  #
#     #     #        #     #  #     #  #  #     #  #        #
####  #  ####  #  #######  #  #  #  ####  ####  #  ####  #  #
#           #  #                 #     #     #  #        #  #
####  #  #  #  #  #  ####  #  #  #######  #  #  #  #  #  #  #
#  #  #  #  #  #  #  #     #  #        #  #     #  #  #  #  #
#  #  ####  #  ##########  #  #  ####  ###################  #
#  #  #        #        #  #  #     #  #  #  #     #  #     #
#  #######  #  ####  ##########  #######  #  #  #  #  ####  #
#     #  #  #        #  #     #  #  #        #  #  #  #     #
####  #  ####  #######  ####  ####  #  #  #  #  ####  ####  #
#  #           #     #  #  #        #  #  #           #     #
#  #######  ####  ####  #  #  ###################  ####  #  #
#                 #     #     #  #                    #  #  #
#  ####  #  #######  #  #  #  #  #  #  #  #  #  #  ####  ####
#     #  #  #  #  #  #     #     #  #  #  #  #  #  #        #
##########  #  #  #  #  #############  ####  ####  ####  ####
#           #  #  #  #           #     #  #  #        #     #
#  #  #######  #  #  #  ################  #  #############  #
#  #     #           #     #  #           #  #        #     #
####  #  #  ##########  ####  #  #######  #  #  ##########  #
#     #  #  #        #  #        #     #                    #
####  #  ####  ####  #  #  #######  #############  ####  ####
#     #  #        #                 #              #
##########################################################
