   ##########################################################
         #                             #     #  #  #        #
#  ####  ####  ####  #  #  ####  #######  #  #  #  #  #  #  #
#  #        #     #  #  #     #  #     #  #  #        #  #  #
####  #  #############  ####  #  ####  #  #  #  #############
#  #  #  #              #  #  #  #     #  #  #  #        #  #
#  ####  #  #  #  #  #  #  #  ####  #  #  #  #  #######  #  #
#     #     #  #  #  #  #  #  #     #  #  #           #     #
#  ####  #  ##########  #  #######  #  ####  ####  ####  #  #
#        #  #     #  #     #     #  #  #        #     #  #  #
##########  ####  #  #  ####  #######  #  ####  #######  ####
#  #  #           #     #  #  #        #  #  #        #     #
#  #  ####  #  #######  #  #  #######  #  #  ##########  ####
#  #        #  #  #  #           #  #     #        #     #  #
#  #######  ####  #  ####  ####  #  ####  ####  #  ####  #  #
#        #     #     #        #  #              #        #  #
#  ##########  ####  ####  #  #  #  #  #  #  #######  #  #  #
#  #        #  #     #     #  #     #  #  #     #     #     #
#  #  #############  #  ####  #  ####  ###################  #
#  #                 #     #  #  #  #  #     #           #  #
#  #  ####  #  ####  #  #######  #  #######  ##########  #  #
#        #  #  #  #        #     #        #  #  #  #     #  #
#######  #######  #######  ####  #  #  ####  #  #  ####  #  #
#              #  #  #        #     #     #  #  #     #     #
#  ####  #  #  #  #  #  ####  #######  ####  #  #  #  #  ####
#     #  #  #     #     #     #     #     #        #     #  #
##########  #  #  ##########  #  #############  #  ####  #  #
#           #  #  #  #              #     #     #     #     #
#######  #######  #  #  #######  ####  #  #######  #######  #
#  #     #     #     #  #     #  #  #  #  #  #        #     #
#  #  ####  ################  ####  ####  #  #  #  ##########
#           #        #        #     #  #        #  #  #     #
#  ####  ####  ####  ####  ####  ####  #######  ####  #  ####
#  #        #     #  #  #        #     #  #  #  #           #
#  #  #  ####  #  ####  ####  ####  ####  #  #  #  #  #  #  #
#  #  #  #  #  #                    #  #           #  #  #  #
####  ####  #  ####  #######  ####  #  ####  #  #  #######  #
#  #  #     #  #     #           #     #     #  #  #  #     #
#  ####  #######  #######  #######  #  ####  #######  #  ####
#                 #              #  #                 #     #
#############################################################