###############
#             #
#   #         #
#   #    #    #
#   #    #    #
#   #    #    #
#   #         #
#   #         #
#####     #####
###############
